DROHTSPITZ:	Drohtspitz
ADDES	Addes
Addes	Addes
ADDES:	Addes
ADDES - EDDES:	Addes;Eddes
DOREL:	Dorel
Dorel	Dorel
DROHTSPITZ	Drohtspitz
Drohtspitz	Drohtspitz
EDDES	Eddes
EDDES:	Eddes
Eddes	Eddes
LINSER:	Linser
Linser:	Linser
MIRLITON	Mirliton
MIRLITON:	Mirliton
Mirliton	Mirliton
SCHAKOB:	Schakob
Schakob	Schakob
SCHAKOEBEL	Schakoebel
SCHAKOEBEL:	Schakoebel
Schakoebel	Schakoebel
